########################################
#                                      #
#       ?           ?          ?       #
#                                      #
#                                      #
#                                      #
#                                      #
#                                      #
#                                      #
#                                      #
#                                      #
#                                      #
#                                      #
#                                      #
#                                      #
#                   !                  #
#                                      #
#                                      #
#                /     |               #
########################################
